{
    "layers": [
        {
            "tileset": "map.tileset",
            "scroll_speed": [1.0, 1.0],
            "terrain": [
                [0, 725, 725, 725, 725, 725, 725, 725, 725, 725, 725, 725, 725, 725, 725, 725, 725, 725, 725, 725, 725, 725, 725, 725, 725, 725, 725, 725, 725, 0],
                [0, 725, 725, 725, 725, 725, 725, 725, 725, 725, 725, 725, 725, 725, 725, 725, 725, 725, 725, 725, 725, 725, 725, 725, 725, 725, 725, 725, 725, 0],
                [0, 725, 725, 725, 725, 725, 725, 725, 725, 725, 725, 725, 725, 725, 725, 725, 725, 725, 725, 725, 725, 725, 725, 725, 725, 725, 725, 725, 725, 0],
                [0, 725, 725, 725, 725, 725, 725, 725, 725, 725, 725, 725, 725, 725, 725, 725, 725, 725, 725, 725, 725, 725, 725, 725, 725, 725, 725, 725, 725, 0],
                [0, 725, 725, 725, 725, 725, 725, 725, 3, 3, 3, 725, 725, 725, 725, 3, 3, 3, 3, 3, 725, 725, 725, 725, 725, 725, 725, 725, 725, 0],
                [0, 725, 725, 725, 725, 725, 725, 725, 3, 3, 3, 725, 725, 725, 725, 3, 3, 3, 3, 3, 725, 725, 725, 725, 725, 725, 725, 725, 725, 0],
                [0, 725, 725, 725, 725, 725, 725, 725, 725, 725, 725, 725, 725, 725, 725, 725, 725, 725, 725, 725, 725, 725, 725, 725, 725, 725, 725, 725, 725, 0],
                [0, 725, 725, 725, 0, 725, 725, 725, 725, 725, 725, 725, 725, 725, 725, 725, 725, 725, 725, 725, 725, 725, 725, 725, 725, 725, 725, 725, 725, 0],
                [725, 241, 241, 241, 241, 241, 241, 241, 241, 241, 241, 241, 241, 241, 241, 241, 241, 241, 241, 241, 241, 241, 241, 241, 241, 241, 241, 241, 241, 725],
                [725, 241, 241, 241, 241, 241, 241, 241, 241, 241, 241, 241, 241, 241, 241, 241, 241, 241, 241, 241, 241, 241, 241, 241, 241, 241, 241, 241, 241, 725],
                [725, 241, 241, 241, 241, 241, 241, 241, 241, 241, 241, 241, 241, 241, 241, 241, 241, 241, 241, 241, 241, 241, 241, 241, 241, 241, 241, 241, 241, 725],
                [725, 241, 241, 241, 241, 241, 241, 241, 241, 241, 241, 241, 241, 241, 241, 241, 241, 241, 241, 241, 241, 241, 241, 241, 241, 241, 241, 241, 241, 725],
                [725, 241, 241, 241, 241, 241, 241, 241, 241, 241, 241, 241, 241, 241, 241, 241, 241, 241, 241, 241, 241, 241, 241, 241, 241, 241, 241, 241, 241, 725],
                [725, 241, 241, 241, 241, 241, 241, 241, 241, 241, 241, 241, 241, 241, 241, 241, 241, 241, 241, 241, 241, 241, 241, 241, 241, 241, 241, 241, 241, 725],
                [725, 241, 241, 241, 241, 241, 241, 241, 241, 241, 241, 241, 241, 241, 241, 241, 241, 241, 241, 241, 241, 241, 241, 241, 241, 241, 241, 241, 241, 725],
                [0, 273, 274, 273, 274, 273, 274, 273, 274, 273, 274, 273, 274, 273, 274, 273, 274, 273, 274, 273, 274, 273, 274, 273, 274, 273, 274, 273, 274, 0],
                [0, 305, 306, 305, 306, 305, 306, 305, 306, 305, 306, 305, 306, 305, 306, 305, 306, 305, 306, 305, 306, 305, 306, 305, 306, 305, 306, 305, 306, 0],
                [0, 273, 274, 273, 274, 273, 274, 273, 274, 273, 274, 273, 274, 273, 274, 273, 274, 273, 274, 273, 274, 273, 274, 273, 274, 273, 274, 273, 274, 0],
                [0, 305, 306, 305, 306, 305, 306, 305, 306, 305, 306, 305, 306, 305, 306, 305, 306, 305, 306, 305, 306, 305, 306, 305, 306, 305, 306, 305, 306, 0]
            ]
        },
        {
            "tileset": "map.tileset",
            "scroll_speed": [1.0, 1.0],
            "terrain": [
                [0, 0, 0, 0, 0, 0, 0, 0, 0, 0, 0, 0, 0, 0, 0, 0, 0, 0, 0, 0, 0, 0, 0, 0, 0, 0, 0, 0, 0, 0],
                [0, 0, 0, 0, 0, 0, 0, 0, 0, 0, 0, 0, 0, 0, 0, 0, 0, 0, 0, 0, 0, 0, 0, 0, 0, 0, 0, 0, 0, 0],
                [0, 0, 0, 0, 0, 0, 0, 0, 0, 0, 0, 0, 0, 0, 0, 0, 0, 0, 0, 0, 0, 0, 0, 0, 0, 0, 0, 0, 0, 0],
                [0, 0, 0, 0, 0, 0, 0, 0, 0, 0, 0, 0, 0, 0, 0, 0, 0, 0, 0, 0, 0, 0, 0, 0, 0, 0, 0, 0, 0, 0],
                [0, 0, 0, 0, 0, 0, 0, 0, 0, 0, 0, 0, 0, 0, 0, 0, 0, 0, 0, 0, 0, 0, 0, 0, 0, 0, 0, 0, 0, 0],
                [0, 0, 0, 0, 0, 0, 0, 0, 0, 0, 0, 0, 0, 0, 0, 0, 0, 0, 0, 0, 0, 0, 0, 0, 0, 0, 0, 0, 0, 0],
                [0, 0, 0, 0, 1956, 0, 0, 0, 0, 0, 0, 0, 0, 0, 0, 0, 0, 0, 0, 0, 0, 0, 0, 0, 0, 0, 0, 0, 0, 0],
                [0, 0, 0, 0, 1988, 0, 0, 0, 1461, 0, 0, 1464, 0, 0, 0, 0, 0, 0, 0, 0, 0, 0, 0, 0, 0, 0, 0, 0, 0, 0],
                [0, 0, 0, 0, 0, 0, 0, 0, 1493, 1494, 1495, 1496, 0, 0, 0, 0, 0, 0, 0, 0, 0, 0, 0, 0, 0, 0, 0, 0, 0, 0],
                [0, 0, 0, 0, 0, 0, 0, 0, 1525, 1526, 1527, 1528, 0, 0, 0, 0, 0, 0, 0, 0, 0, 1622, 1622, 0, 0, 0, 0, 0, 0, 0],
                [0, 0, 0, 0, 0, 0, 0, 0, 0, 0, 0, 0, 0, 0, 0, 0, 0, 0, 0, 0, 0, 1587, 1587, 0, 0, 0, 0, 0, 0, 0],
                [0, 0, 0, 0, 0, 0, 0, 0, 0, 0, 0, 0, 0, 0, 0, 0, 1622, 1622, 0, 0, 0, 1587, 1587, 0, 0, 0, 0, 0, 0],
                [0, 0, 0, 0, 0, 0, 0, 0, 0, 0, 0, 0, 0, 0, 0, 0, 1587, 1587, 0, 0, 0, 1623, 1623, 0, 0, 0, 0, 0, 0, 0],
                [0, 0, 0, 0, 0, 0, 0, 0, 0, 0, 0, 0, 0, 0, 0, 0, 1587, 1587, 0, 0, 0, 0, 0, 0, 0, 0, 0, 0, 0, 0],
                [0, 0, 0, 0, 0, 0, 1623, 1623, 1623, 0, 0, 0, 0, 0, 0, 0, 1623, 1623, 0, 0, 0, 0, 0, 0, 0, 0, 0, 0, 0, 0],
                [0, 0, 0, 0, 0, 0, 0, 0, 0, 0, 0, 0, 0, 0, 0, 0, 0, 0, 0, 0, 0, 0, 0, 0, 0, 0, 0, 0, 0, 0],
                [0, 0, 0, 0, 0, 0, 0, 0, 0, 0, 0, 0, 0, 0, 0, 0, 0, 0, 0, 0, 0, 0, 0, 0, 0, 0, 0, 0, 0, 0],
                [0, 0, 0, 0, 0, 0, 0, 0, 0, 0, 0, 0, 0, 0, 0, 0, 0, 0, 0, 0, 0, 0, 0, 0, 0, 0, 0, 0, 0, 0]
            ]
        }
    ],
    "entities": [
        {
            "file": "breton.ent",
            "name": "npc",
            "pos": [620.0, 300.0],
            "persistant": 0,
            "dialogues": [
                {
                    "conditions": [
                        {
                            "type": "quest",
                            "quest": "none"
                        }
                    ],
                    "file": "breton_talk.dial"
                },
                {
                    "conditions": [
                        {
                            "type": "quest",
                            "quest": "killbreton.quest:kill"
                        }
                    ],
                    "file": "breton_fight.dial"
                },
                {
                    "conditions": [
                        {
                            "type": "quest",
                            "quest": "killbreton.quest:redeem"
                        }
                    ],
                    "file": "breton_after_fight.dial"
                }
            ]
        },
        {
            "file": "loading_zone.ent",
            "name": "load_zone_corridor",
            "extra_data": {
                "map": "corridor.map",
                "entity": "player",
                "pos_x": 768.0,
                "pos_y": 275.0
            },
            "persistant": 0,
            "pos": [96.0, 224.0]
        }
    ]
}