{
    "layers": [
        {
            "tileset": "map.tileset",
            "scroll_speed": [1.0, 1.0],
            "terrain": [
                [0, 793, 793, 793, 793, 793, 793, 793, 793, 793, 793, 793, 793, 793, 793, 793, 793, 793, 793, 793, 793, 793, 793, 793, 793, 793, 793, 793, 793, 0],
                [0, 793, 793, 793, 793, 793, 793, 793, 793, 793, 793, 793, 793, 793, 793, 793, 793, 793, 793, 793, 793, 793, 793, 793, 793, 793, 793, 793, 793, 0],
                [0, 793, 793, 793, 793, 793, 793, 793, 793, 793, 793, 793, 793, 793, 793, 793, 793, 793, 793, 793, 793, 793, 793, 793, 793, 793, 793, 793, 793, 0],
                [0, 793, 793, 793, 793, 793, 793, 793, 793, 793, 793, 793, 793, 793, 793, 793, 793, 793, 793, 793, 793, 793, 793, 793, 793, 793, 793, 793, 793, 0],
                [0, 793, 793, 793, 793, 793, 793, 793, 793, 793, 793, 793, 793, 793, 793, 793, 793, 793, 793, 793, 793, 793, 793, 793, 793, 793, 793, 793, 793, 0],
                [0, 793, 793, 793, 793, 793, 793, 793, 793, 793, 793, 793, 793, 793, 793, 793, 793, 793, 793, 793, 793, 793, 793, 793, 793, 793, 793, 793, 793, 0],
                [0, 793, 793, 793, 793, 793, 793, 793, 793, 793, 793, 793, 793, 793, 793, 793, 793, 793, 793, 793, 793, 793, 793, 793, 793, 793, 793, 793, 793, 0],
                [0, 793, 793, 793, 0, 793, 793, 793, 793, 793, 793, 793, 793, 793, 793, 793, 793, 793, 793, 793, 793, 793, 793, 793, 793, 0, 793, 793, 793, 0],
                [793, 241, 241, 241, 241, 241, 241, 241, 241, 241, 241, 241, 241, 241, 241, 241, 241, 241, 241, 241, 241, 241, 241, 241, 241, 241, 241, 241, 241, 793],
                [793, 241, 241, 241, 241, 241, 241, 241, 241, 241, 241, 241, 241, 241, 241, 241, 241, 241, 241, 241, 241, 241, 241, 241, 241, 241, 241, 241, 241, 793],
                [793, 241, 241, 241, 241, 241, 241, 241, 241, 241, 241, 241, 241, 241, 241, 241, 241, 241, 241, 241, 241, 241, 241, 241, 241, 241, 241, 241, 241, 793],
                [793, 241, 241, 241, 241, 241, 241, 241, 241, 241, 241, 241, 241, 241, 241, 241, 241, 241, 241, 241, 241, 241, 241, 241, 241, 241, 241, 241, 241, 793],
                [793, 241, 241, 241, 241, 241, 241, 241, 241, 241, 241, 241, 241, 241, 241, 241, 241, 241, 241, 241, 241, 241, 241, 241, 241, 241, 241, 241, 241, 793],
                [793, 241, 241, 241, 241, 241, 241, 241, 241, 241, 241, 241, 241, 241, 241, 241, 241, 241, 241, 241, 241, 241, 241, 241, 241, 241, 241, 241, 241, 793],
                [793, 241, 241, 241, 241, 241, 241, 241, 241, 241, 241, 241, 241, 241, 241, 241, 241, 241, 241, 241, 241, 241, 241, 241, 241, 241, 241, 241, 241, 793],
                [0, 273, 274, 273, 274, 273, 274, 273, 274, 273, 274, 273, 274, 273, 274, 273, 274, 273, 274, 273, 274, 273, 274, 273, 274, 273, 274, 273, 274, 0],
                [0, 305, 306, 305, 306, 305, 306, 305, 306, 305, 306, 305, 306, 305, 306, 305, 306, 305, 306, 305, 306, 305, 306, 305, 306, 305, 306, 305, 306, 0],
                [0, 273, 274, 273, 274, 273, 274, 273, 274, 273, 274, 273, 274, 273, 274, 273, 274, 273, 274, 273, 274, 273, 274, 273, 274, 273, 274, 273, 274, 0],
                [0, 305, 306, 305, 306, 305, 306, 305, 306, 305, 306, 305, 306, 305, 306, 305, 306, 305, 306, 305, 306, 305, 306, 305, 306, 305, 306, 305, 306, 0]
            ]
        },
        {
            "tileset": "map.tileset",
            "scroll_speed": [1.0, 1.0],
            "terrain": [
                [0, 0, 0, 0, 0, 0, 0, 0, 0, 0, 0, 0, 0, 0, 0, 0, 0, 0, 0, 0, 0, 0, 0, 0, 0, 0, 0, 0, 0],
                [0, 0, 0, 0, 0, 0, 0, 0, 0, 0, 0, 0, 0, 0, 0, 0, 0, 0, 0, 0, 0, 0, 0, 0, 0, 0, 0, 0, 0],
                [0, 0, 0, 0, 0, 0, 0, 0, 0, 0, 0, 0, 0, 0, 0, 0, 0, 0, 0, 0, 0, 0, 0, 0, 0, 0, 0, 0, 0],
                [0, 0, 0, 0, 0, 0, 0, 0, 0, 0, 0, 0, 0, 0, 0, 0, 0, 0, 0, 0, 0, 0, 0, 0, 0, 0, 0, 0, 0],
                [0, 0, 0, 0, 0, 0, 0, 0, 0, 0, 0, 0, 0, 0, 0, 0, 0, 0, 0, 0, 0, 0, 0, 0, 0, 0, 0, 0, 0],
                [0, 0, 0, 0, 0, 0, 0, 0, 0, 0, 0, 0, 0, 0, 0, 0, 0, 0, 0, 0, 0, 0, 0, 0, 0, 0, 0, 0, 0],
                [0, 0, 0, 0, 1956, 0, 0, 0, 1753, 1754, 0, 0, 0, 0, 0, 0, 0, 0, 0, 0, 0, 0, 0, 1746, 0, 1956, 0, 0, 0],
                [0, 0, 0, 0, 1988, 0, 0, 0, 0, 0, 0, 0, 0, 0, 0, 0, 0, 0, 1363, 1364, 0, 0, 0, 1778, 0, 1988, 0, 0, 0],
                [0, 0, 0, 0, 0, 0, 0, 0, 0, 0, 0, 0, 0, 0, 1622, 1622, 0, 0, 1395, 1396, 0, 0, 0, 0, 0, 0, 0, 0, 0],
                [0, 0, 0, 0, 0, 0, 0, 0, 0, 0, 0, 0, 0, 0, 1587, 1587, 0, 0, 0, 0, 0, 0, 0, 0, 0, 0, 0, 0, 0],
                [0, 0, 0, 0, 0, 0, 0, 0, 0, 0, 0, 0, 0, 0, 1623, 1623, 0, 0, 0, 0, 0, 0, 0, 0, 0, 0, 0, 0, 0],
                [0, 0, 0, 0, 0, 0, 0, 0, 0, 0, 0, 0, 0, 0, 0, 0, 0, 0, 0, 0, 0, 0, 0, 0, 0, 0, 0, 0, 0],
                [0, 0, 0, 0, 0, 0, 0, 0, 0, 0, 0, 0, 0, 0, 0, 0, 0, 0, 0, 0, 0, 0, 0, 0, 0, 0, 0, 0, 0],
                [0, 0, 0, 0, 0, 0, 1621, 1621, 1621, 1621, 1621, 1621, 1621, 1621, 0, 0, 0, 0, 1621, 1621, 1621, 1621, 1621, 0, 0, 0, 0, 0, 0],
                [0, 0, 0, 0, 0, 0, 1587, 1587, 1587, 1587, 1587, 1587, 1587, 1587, 0, 0, 0, 0, 1587, 1587, 1587, 1587, 1587, 0, 0, 0, 0, 0, 0],
                [0, 0, 0, 0, 0, 0, 0, 0, 0, 0, 0, 0, 0, 0, 0, 0, 0, 0, 0, 0, 0, 0, 0, 0, 0, 0, 0, 0, 0],
                [0, 0, 0, 0, 0, 0, 0, 0, 0, 0, 0, 0, 0, 0, 0, 0, 0, 0, 0, 0, 0, 0, 0, 0, 0, 0, 0, 0, 0],
                [0, 0, 0, 0, 0, 0, 0, 0, 0, 0, 0, 0, 0, 0, 0, 0, 0, 0, 0, 0, 0, 0, 0, 0, 0, 0, 0, 0, 0],
                [0, 0, 0, 0, 0, 0, 0, 0, 0, 0, 0, 0, 0, 0, 0, 0, 0, 0, 0, 0, 0, 0, 0, 0, 0, 0, 0, 0, 0]
            ]
        }
    ],
    "entities": [
        {
            "file": "loading_zone.ent",
            "name": "load_zone_office",
            "extra_data": {
                "map": "office.map",
                "entity": "player",
                "pos_x": 768.0,
                "pos_y": 275.0
            },
            "persistant": 0,
            "pos": [96.0, 224.0]
        },
        {
            "file": "loading_zone.ent",
            "name": "load_zone_bde",
            "extra_data": {
                "map": "bde.map",
                "entity": "player",
                "pos_x": 96.0,
                "pos_y": 275.0
            },
            "persistant": 0,
            "pos": [768.0, 224.0]
        }
    ]
}