{
    "layers": [
        {
            "tileset": "map.tileset",
            "scroll_speed": [1.0, 1.0],
            "terrain": [
                [0, 725, 725, 725, 725, 725, 725, 725, 725, 725, 725, 725, 725, 725, 725, 725, 725, 725, 725, 725, 725, 725, 725, 725, 725, 725, 725, 725, 725, 0],
                [0, 725, 725, 725, 725, 725, 725, 725, 725, 725, 725, 725, 725, 725, 725, 725, 725, 725, 725, 725, 725, 725, 725, 725, 725, 725, 725, 725, 725, 0],
                [0, 725, 725, 725, 725, 725, 725, 725, 725, 725, 725, 725, 725, 725, 725, 725, 725, 725, 725, 725, 725, 725, 725, 725, 725, 725, 725, 725, 725, 0],
                [0, 725, 725, 725, 725, 725, 725, 725, 725, 725, 725, 725, 725, 725, 725, 725, 725, 725, 725, 725, 725, 725, 725, 725, 725, 725, 725, 725, 725, 0],
                [0, 725, 725, 725, 725, 725, 3, 3, 3, 3, 3, 725, 725, 725, 725, 725, 3, 3, 3, 3, 3, 725, 725, 725, 725, 725, 725, 725, 725, 725, 725, 0],
                [0, 725, 725, 725, 725, 725, 3, 3, 3, 3, 3, 725, 725, 725, 725, 725, 3, 3, 3, 3, 3, 725, 725, 725, 725, 725, 725, 725, 725, 725, 725, 0],
                [0, 725, 725, 725, 725, 725, 725, 725, 725, 725, 725, 725, 725, 725, 725, 725, 725, 725, 725, 725, 725, 725, 725, 725, 725, 725, 725, 725, 725, 725, 0],
                [0, 725, 725, 725, 725, 725, 725, 725, 725, 725, 725, 725, 725, 725, 725, 725, 725, 725, 725, 725, 725, 725, 725, 725, 725, 725, 0, 725, 725, 725, 0],
                [725, 241, 241, 241, 241, 241, 241, 241, 241, 241, 241, 241, 241, 241, 241, 241, 241, 241, 241, 241, 241, 241, 241, 241, 241, 241, 241, 241, 241, 725],
                [725, 241, 241, 241, 241, 241, 241, 241, 241, 241, 241, 241, 241, 241, 241, 241, 241, 241, 241, 241, 241, 241, 241, 241, 241, 241, 241, 241, 241, 725],
                [725, 241, 241, 241, 241, 241, 241, 241, 241, 241, 241, 241, 241, 241, 241, 241, 241, 241, 241, 241, 241, 241, 241, 241, 241, 241, 241, 241, 241, 725],
                [725, 241, 241, 241, 241, 241, 241, 241, 241, 241, 241, 241, 241, 241, 241, 241, 241, 241, 241, 241, 241, 241, 241, 241, 241, 241, 241, 241, 241, 725],
                [725, 241, 241, 241, 241, 241, 241, 241, 241, 241, 241, 241, 241, 241, 241, 241, 241, 241, 241, 241, 241, 241, 241, 241, 241, 241, 241, 241, 241, 725],
                [725, 241, 241, 241, 241, 241, 241, 241, 241, 241, 241, 241, 241, 241, 241, 241, 241, 241, 241, 241, 241, 241, 241, 241, 241, 241, 241, 241, 241, 725],
                [725, 241, 241, 241, 241, 241, 241, 241, 241, 241, 241, 241, 241, 241, 241, 241, 241, 241, 241, 241, 241, 241, 241, 241, 241, 241, 241, 241, 241, 725],
                [0, 273, 274, 273, 274, 273, 274, 273, 274, 273, 274, 273, 274, 273, 274, 273, 274, 273, 274, 273, 274, 273, 274, 273, 274, 273, 274, 273, 274, 0],
                [0, 305, 306, 305, 306, 305, 306, 305, 306, 305, 306, 305, 306, 305, 306, 305, 306, 305, 306, 305, 306, 305, 306, 305, 306, 305, 306, 305, 306, 0],
                [0, 273, 274, 273, 274, 273, 274, 273, 274, 273, 274, 273, 274, 273, 274, 273, 274, 273, 274, 273, 274, 273, 274, 273, 274, 273, 274, 273, 274, 0],
                [0, 305, 306, 305, 306, 305, 306, 305, 306, 305, 306, 305, 306, 305, 306, 305, 306, 305, 306, 305, 306, 305, 306, 305, 306, 305, 306, 305, 306, 0]
            ]
        },
        {
            "tileset": "map.tileset",
            "scroll_speed": [1.0, 1.0],
            "terrain": [
                [0, 0, 0, 0, 0, 0, 0, 0, 0, 0, 0, 0, 0, 0, 0, 0, 0, 0, 0, 0, 0, 0, 0, 0, 0, 0, 0, 0, 0, 0],
                [0, 0, 0, 0, 0, 0, 0, 0, 0, 0, 0, 0, 0, 0, 0, 0, 0, 0, 0, 0, 0, 0, 0, 0, 0, 0, 0, 0, 0, 0],
                [0, 0, 0, 0, 0, 0, 0, 0, 0, 0, 0, 0, 0, 0, 0, 0, 0, 0, 0, 0, 0, 0, 0, 0, 0, 0, 0, 0, 0, 0],
                [0, 0, 0, 0, 0, 0, 0, 0, 0, 0, 0, 0, 0, 0, 0, 0, 0, 0, 0, 0, 0, 0, 0, 0, 0, 0, 0, 0, 0, 0],
                [0, 0, 0, 0, 0, 0, 1687, 0, 0, 0, 1688, 0, 0, 0, 0, 0, 1687, 0, 0, 0, 1688, 0, 0, 0, 0, 0, 0, 0, 0, 0],
                [0, 0, 0, 0, 0, 0, 1719, 0, 0, 0, 1720, 0, 0, 0, 0, 0, 1719, 0, 0, 0, 1720, 0, 0, 0, 0, 0, 0, 0, 0, 0],
                [0, 0, 0, 0, 0, 0, 0, 0, 0, 0, 0, 1747, 1748, 0, 0, 0, 0, 0, 0, 0, 0, 0, 0, 0, 1746, 0, 1956, 0, 0, 0],
                [0, 0, 1235, 1236, 0, 0, 0, 0, 1299, 0, 0, 1779, 1780, 0, 1363, 1364, 0, 0, 0, 0, 1844, 0, 0, 0, 1778, 0, 1988, 0, 0, 0],
                [0, 0, 1267, 1268, 0, 1621, 0, 0, 1331, 0, 0, 1621, 0, 0, 1395, 1396, 0, 0, 1621, 0, 1876, 0, 0, 0, 0, 0, 0],
                [0, 0, 0, 0, 1529, 1530, 1532, 0, 0, 0, 1529, 1530, 1532, 0, 0, 0, 0, 1529, 1530, 1532, 0, 0, 0, 0],
                [0, 0, 0, 0, 0, 1653, 0, 0, 0, 0, 0, 1653, 0, 0, 0, 0, 0, 0, 1653, 0, 0, 0, 0, 0, 0, 0, 0, 0, 0, 0],
                [0, 0, 0, 0, 0, 0, 0, 0, 0, 0, 0, 0, 0, 0, 0, 0, 0, 0, 0, 0, 0, 0, 0, 0, 0, 0, 0, 0, 0, 0],
                [0, 0, 0, 0, 0, 0, 0, 0, 0, 0, 0, 0, 0, 0, 0, 0, 0, 0, 0, 0, 0, 0, 0, 0, 0, 0, 0, 0, 0, 0],
                [0, 0, 0, 0, 0, 0, 0, 0, 0, 0, 0, 0, 0, 0, 0, 0, 0, 0, 0, 0, 0, 0, 0, 0, 0, 0, 0, 0, 0, 0],
                [0, 0, 0, 0, 0, 0, 0, 0, 0, 0, 0, 0, 0, 0, 0, 0, 0, 0, 0, 0, 0, 0, 0, 0, 0, 0, 0, 0, 0, 0],
                [0, 0, 0, 0, 0, 0, 0, 0, 0, 0, 0, 0, 0, 0, 0, 0, 0, 0, 0, 0, 0, 0, 0, 0, 0, 0, 0, 0, 0, 0],
                [0, 0, 0, 0, 0, 0, 0, 0, 0, 0, 0, 0, 0, 0, 0, 0, 0, 0, 0, 0, 0, 0, 0, 0, 0, 0, 0, 0, 0, 0],
                [0, 0, 0, 0, 0, 0, 0, 0, 0, 0, 0, 0, 0, 0, 0, 0, 0, 0, 0, 0, 0, 0, 0, 0, 0, 0, 0, 0, 0, 0]
            ]
        }
    ],
    "entities": [
        {
            "file": "henric.ent",
            "name": "npc_henric",
            "pos": [195.0, 265.0],
            "persistant": 0,
            "dialogues": [
                {
                    "conditions": [
                        {
                            "type": "quest",
                            "quest": "none"
                        }
                    ],
                    "file": "quest_killbreton_give.dial"
                },
                {
                    "conditions": [
                        {
                            "type": "quest",
                            "quest": "killbreton.quest:kill"
                        }
                    ],
                    "file": "quest_killbreton_during.dial"
                },
                {
                    "conditions": [
                        {
                            "type": "quest",
                            "quest": "killbreton.quest:redeem"
                        }
                    ],
                    "file": "quest_killbreton_redeem.dial"
                }
            ]
        },
        {
            "file": "main_char.ent",
            "name": "player",
            "pos": [750.0, 350.0],
            "persistant": 1
        },
        {
            "file": "loading_zone.ent",
            "name": "load_zone_corridor",
            "extra_data": {
                "map": "corridor.map",
                "entity": "player",
                "pos_x": 96.0,
                "pos_y": 275.0
            },
            "persistant": 0,
            "pos": [800.0, 224.0]
        }
    ]
}